####  ###########
# @       @  !@ #
     /    @ @ @ #
#  @ @  @@      #
#           #   #
#     @@@@@@    #
#     @  ! D    #
#  @@@  @  @    #
# !        @ !@ #
########   ######
100