#####################
# @ A#  @   !@  #@# #
# B  #  /  # @@# F@ #
#@##@##    @     !  #
# #    #  #@###     #
#@#  #@#   #  B  !  #
# !  C  @## #   @   #
#@  ##   @   @  @@  #
# !  @#!@  A   @  D #
#     #  @      #   #
# @      ##  !  @   #
#####################
60