####  ###########
# @     F     @ #
 C   /    B @   #
#  @     @      #
#     A     #   #
#        @      #
#        ! D    #
#            #  #
# !           @ #
########   ######
180