#####################
# @       @     !   #
#    /    @ @   #   #
#  @   ###  # C###  #
#       #   #   @   #
#   #   ####  @     #
#   @   !   ##D     #
#   B  @   @  #     #
# !   @  #    !@    #
#########   #########
#   @   #      @    #
#  @   ###  !  @    #
#####################
100