####  ###########
# @           @ #
     /      @   #
#  @     @      #
#           #   #
#        @      #
#     @  ! D    #
#     @      #  #
# !           @ #
########   ######
180