####  ###########
# @       @  !@ #
     /    @ @ @ #
#  @ @  @@      #
#   #       #   #
#@@@# @@@@@@   !#
#   # @  ! D    #
#  @@@  @  @    #
# ! @ !     @ !@#
########   ######
50